::::::::::::::::::::::::::::::::::::::::............................::::::::::::::::::::::::::::::::::::::::::::::::::::::::::::::::::::::::::::::::::::::::::::::::::::::::::::............  ''''''::::::
::::::::::::::::::::::::::::::::::::::::............................::::::::::::::::::::::::::::::::::::::::::::::::::::::::::::::::::::::::::::::::::::::::::::::::::::::::::::::::::::::::::......::::::
::::::::::::::::::::::::::::::::::;;;;;;;;:::::X@@@@@@@@@@@@X''''''''''''@@@@@@@@@@@@@L'''''''::;;;;;;;;;;;;;;;;;;;;;;'''''''''''';;;;;;;;;;;;;;;;;;;;;;;;;;;;;;;;;;;;;;;;;;;;;;;;;;;;;;;;;;::......::::::
::::::::::::::::::::::::::::::::::;;;;;;;oo:::XX@@@@@@@@@@@@XXOOOOOOOOOOOO@@@@@@@@@@@@LL''''''::;;;;;;;;;;;;;;;;;;;;;;'''''''''''';;;;;;;;;;;;;;;;;;;;;;;;;;;;;ooo;;;;;;;;;;;;;;;;;;;;;;;;;;::::::::::::::
''''::::::::::::::::::''''ggHH@@@@::@@@@YYOOHHOOOOOOOOOO..OOOOOOOOOOOOOOOOOOOOOOOOOOOOOOOO::::::::::::::::::VV@@@@@@@@                                      """"O@@@@@@@    ''''''''''''''                
''''::::::::::::::::::'oooggHH@@@@::@@@@YYOOHHOOOOOOOOOO..OOOOOOOOOOOOOOOOOOOOOOOOOOOOOOOO::::::::::::::::::::@@@@@@@                    @@@@@@@           """"YYoooooOOooooo               @@@           
  ::::::::::::::::    OO@@YYoo  OOOO @OOOOOOYYOOOOOOyy    ....  @@OOOOOOOOOOOOOOOOOOOOO@@'  ::::::::::::::::::::                      @@YYO   @@@@@@@@@@@@@@@@@@@@@@@@@@@@@@@@@@@@@@ww@@@  YWWWW@@ooo     
  ::::::::::::::::    OO@@YYOo@@OOO @@OOOOO YYOOOOOOyy    ....  @@OOOOOOOOOOOOOOOOOOOO@@'   ::::::::::::::::::::                      @@Y:    @@@@@@@@@@@@@@@@@@@@@@@@@@@@@@@@@@@@@@ww@@@@YYWWWW@@@@@@@   
@@@@@@@@@@@@@@@@@@@@@@@@@@@@@@OOOOOOOOOOOOOOOOOOOOOOOOOOOOOO      OOOOOOOOOOOOOOOOOOOO          ::::::''''''''   @OO@@@@OO@@@@   i  @@OOOO@@@@OOOO@@@@@@@@@@@@@@@@@@@@@@@@@@@@@@@@@@@@@@@@@@@@@@@@@@@@@@@@
@@@@@@@@@@@@@@@@@@@@@@@@@@@@@@OOOOOOOOOOOOOOOOOOOOOOOOOOOOOO      OOOOOOOOOOOOOOOOOO            ::::::'''''''' O@OOO@@@@OO@@@@  i@@@@@OOOO@@@@OOOO@@@@@@@@@@@@@@@@@@@@@@@@@@@@@@@@@@@@@@@@@@@@@@@@@@@@@@@@
@@@@@@@@@@@@@@@@@@@@OO@@@@@@@@@@@@@@@@@@OOOOOO..OO::::OOOOOOOO  ....@@OOOOOO@ ......  @@@@@@      ''       @@@@@@@@@@@@@@@@@@@@@@@@@@@@@@@@@@@@@@@@@@@@@@@@@@@@@@@@@@@@@@@@@@@@@@@@@@@@@@@@@OOOOOO@@@@@@@@
@@@@@@@@@@@@@@@@@@@@OO@@@@@@@@@@@@@@@@@@OOOOOO..OO::::OOOOOOOO  ....@@OOOOo@  ......   @@@o       ''     @@@@@@@@ @@@@@@@@@@@@@@@@@@@@@@@@@@@@@@@@@@@@@@@@@@@@@@@@@@@@@@@@@@@@@@@@@@@@@@@@@@OOOOOO@@@@@@@@
@@@@@@@@OOOOoooooooo@@@@@@@@@@@@@@@@@@@@@@          OOOOOO  OO  :::::::::o::::::::  ::::    ::          OO@@@@@@  @@@@@@@@@@@@@@@@@@@@@@@@@@@@@@@@@@@@@@@@@@@@@@@@@@@@@@@@@@@@@@@@@@@@@@@@@@oooooooooooo  
@@@@@@@ ::::oooooooo@@@@@@@@@@@@@@@@@@@@@@          OOOOOO  OO  :::::::::::::::::  :::::    ::  @@      OO@@@@@@  @@@@@@@@@@@@@@@@@@@@@@@@@@@@@@@@@@@@@@@@@@@@@@@@@@@@@@@@@@@@@@@@@@@@@@@@@@oooooooooo@@  
 @  ....::::::::..OO@@@@@@@@@@@@@@@@@@@@@@@@@@oooo  oo@@@@@@@@oo    ::::::::::: ::::::......   W@@@@    @@oooo    @@@@@@@@@@@@@@@@@@@@@@@@@@@@@@@@@@@@@@@@@@@@@@@@@@@@@@@@@@@@OOOOOO@@@@@@@@@          @@@
    ....::::::::.. @@@@@@@@@@@@@@@@@@@@@@@@@@@oooo  oo@@@@@@@@oo    ::::::::::. ::::::......  W@@@@@o   @@oooo@@@@@@@@@@@@@@@@@@@@@@@@@@@@@@@@@@@@@@@@@@@@@@@@@@@@@@@@@@@@@@@@OOOOOO@@@@@@@@@@@        @@@
::::::::::::::::::::.@WW@@@@@@@@@@@@@@@@@@@@@@@@@@@@@@@@@@@@@@YYYY@@    ::::::::::  ::::::::..    @@@o ooooooo@@@@@@@@@@@@@@@@@@@@OOOOOOOOOOOOOOOOOOOOOOOO@@@@OOOOOO@@@@@@@@OO@@@@@@@@@@@@@@@@@@        ..
::::::::::::::::::::.@WW@@@@@@@@@@@@@@@@@@@@@@@@@@@@@@@@@@@@@@YYYY@@    ::::::::::  ::::::::..      oooooooooo@@@@@@@@@@@@@@@@@@@@OOOOOOOOOOOOOOOOOOOOOOOO@@@@OOOOOO@@@@@@@@OO@@@@@@@@@@@@@@@@ @        ..
:::::::::::::::::::    @@@OO@@@@OOOOOO@@@@@@@@@@@@@@@@@@@@@@@@@@      ....::::::::   :::::::::::....@@@@@@@@@@@@@@@@@@OOVV  @@@@@@OOOOOOOOOOOOOOOOOOOOOOOOOOOOOOOOOOOOOOOOOOOO@@OOOO@@@@@@@@@@::::..::::::
::::::::::::::::::     @@@OO@@@@OOOOOO@@@@@@@@@@@@@@@@@@@@@@@@@@      ....::::::::   .::::::::::....@@@@@@@@@@@@@@@@@@OOVV  @@@@@@o OOOOOOOOOOOOOOOOOOOOOOOOOOOOOOOOOOOOOOOOOO@@OOOO@@@@@@@@@@::::..::::::
::::::::::::::::.. ....@@@OOOOOOO@@@OO@@@@@@@@@@@@@@@@@@    ....::::::....:::::::   ::....::::@@OOOOOO@@::..@@  @@*@@@..........@@@   OOOOOOOOOOOOOOwwwwwwwwOOOOOOOOOOOOOOOOOOwwwwwwww:::::::@@@::::::::::
::::::::::::::::.......@@@OOOOOOO@@@OO@@@@@@@@@@@@@@@@@@    ....::::::....::::::   .::....::::@@OOOOOO@@::...@@@ @@@@@...........@O@  OOOOOOOOOOOOOOwwwwwwwwOOOOOOOOOOOOOOOOOOwwwwwwww:::::::@@:::::::::::
:::::::::::::::::::::::::@OO@@OOOO@@OOOO@@@@@@@@@@@@@@  :::::::::::::::::::::   ::::::::::::::..OOOOO.OOOOOO oo:::@@  @@@@OOOOOOOOOOOOOOOOOOOOOOOO@@OOOOOOOOOOOOOOOOOOOOOO@@@@@@    @@      :@::::::::::::
::::::::::::::::::::::::::OOO@OOOO@@OOOO@@@@@@@@@@@@@@  ::::::::::::::::::::    ::::::::::::::........OOOOOO  ::::::@     OOOOOOOOOOOOOOOOOOOOOOOO@@OOOOOOOOOOOOOOOOOOOOOO@@@@@@@@@ @@  @@@@@@::::::::::::
::::::::::::::::::::::::::::OOOOOOOOOOOO@@@@@@@@@@@@  ::::::::::::::::::::     .::::::::::::::  OOOOOOOOOOOOOOoooooooo    OOOOOOOOOOOOOOOOOOOOOOOOOO@@OOOOOOOOOO@@@@@@@@@@@@@@@@@@    ::::::  ::::::::::::
::::::::::::::::::::::::::::OOOOOOOOOOOO@@@@@@@@@@@@  ::::::::::::::::::::   .:::::::::::::::: @OOOOOOOOOOOOOOoooooooo@   OOOOOOOOOOOOOOOOOOOOOOOOOO@@OOOOOOOOOO@@@@@@@@@@@@@@@@@@    ::::::  ::::::::::::
:::::::::::::::::::::::::::::@OO@@OOOOOO  :::::: @    :::::::::::::::::   ::::::::::::::::    OOOOOOOOOOOOOOOOOOOOOOOOOOOO@@OOOOOOOO  OOOOOOOOOOOOOOOOOOoo@@@@@@@@@@@@@@@@@@@@@@@@  ::::::::  ::::::::::::
::::::::::::::::::::::::::::O@OO@@OOOOOO  ::::::  @   ::::::::::::::::    ::::::::::::::::  @OOOOOOOOOOOOOOOOOOOOOOOOOOOOO@@OOOOOOOO  OOOOOOOOOOOOOOOOOOoo@@@@@@@@@@@@@@@@@@@@@@@   ::::::::. ::::::::::::
:::::::::::::::::::::::::::::O@::@@@@@@@::::::::    @@''::::::::::::::    :::::::::::::::::@OOOOOOOOOOOOOOOOOOOOOOOOOOOOOO@  @OOOOOOOOOOOO::::::::OOOOOOOOOO@@@@OO@@@@@@ooooooo :::::::::::::: :::::::::::
::::::::::::::::::::::::::::::::::@@@@@@::::::::@@@@@@''::::::::::::::    ::::::::::::::::@OOOOOOOOOOOOOOOOOOOOOOOOOOOOOOOO@ @OOOOOOOOOOOO::::::::OOOOOOOOOO@@@@OO@@@@@@ooooO   ::::::::::::::  ::::::::::
:::::::::::::::::::::::::::::::::::@@@@@@@@@@@@@::::@@::::@@  ::::::::    ::::::::::::::  OOOOOOOOOOOOOOOOOOOOOOOOOOOOOOOOOO@ @@OOOOOOOOOO::::::  OOOOOO@@    @@@@@@@@@@  @:::@@::::::::::::::  ::::::::::
:::::::::::::::::::::::::::::::::::::@@@@@@@@@@@:::::::@@@@@  :::::::::   ::::::::::::::  OOOOOOOOOOOOOOOOOOOOOOOOOOOOOOOOOO@@ @OOOOOOOOo ::::::  OOOOOO@@    @@@@@@@@@@@ @:::@@::::::::::::::  ::::::::::
:::::::::::::::::::::::::::::::::::::::::::@@@@@@@......''::::  ::::::::.  :::::::::::::::@@@@@@@@@@@@@@@@@@OOOOOOOOOOOO@@@@@@@@@OOOOO::::::::::::::@@@@..........@@@@@@@@......@@::::::::::  ::::::::::::
::::::::::::::::::::::::::::::::::::::::::::::@@@@......''::::  ::::::::..  ::::::::::::::@@@@@@@@@@@@@@@@@@OOOOOOOOOOOO@@@@@@@@@O   :::::::::::::::@@@@..........@@@@@@@@......@@::::::::::  ::::::::::::
:::::::::::::::::::::::::::::::::::::::::::::::@::@@@@@@@@@@@@@@   :::::::: ::::''''''''...@@@@@@@@@@@@@@@@@@@@@@@@@@@@@@@@@@@OOO::OO@::::  ::::    @@@@::::::::::@@      ::::::::@@::::::::::     :::::::
::::::::::::::::::::::::::::::::::::::::::::::::@@@@@@@@@@@@@@@@    :::::::: :::''''''''....@@@@@@@@@@@@@@@@@@@@@@@@@@@@@@@@@@OOOOOOO@::::  :::::   @@@@::::::::::@@      ::::::::@@::::::::::      ::::::
::::::::::::::::::::::::::::::::::::::::::::    ::::@@@@@@@@@@@@@@@@@@:::::::.   ::::::::::::::@@@@@@@:::@@@@@@@@@@@@@@@@@@@@OOOOOOOO::::::::::::::::::::::::::::@@@@@@    @@@@::::::::::::::  ::::::    :
::::::::::::::::::::::::::::::::::::::::::::    ::::@@@@@@@@@@@@@@@@@@::::::::::  :::::::::::::::::::::::@@@@@@@@@@@@@@@@@@@OOOOOOOO::::::::::::::::::::::::::::@@@@@@    @@@@::::::::::::::  ::::::    ::
::::::::::::::::::::::::::::::::::::::::::::::::::@@@@@@@@@@@@@@@@@@@@@@oo::::::::  :::::::::::::::::::::::@@@@@@@@@@@@@@@OOOOO@::::::::::::::::::  ::::::::::::::@@@@  @@@@@@  @@@@  ::::::::   :::    ::
::::::::::::::::::::::::::::::::::::::::::::::::::@@@@@@@@@@@@@@@@@@@@@@oo::::::::.          ::::::::::::::@@@@@@@@@@@@@@@OOOO@:::::::::::::::::::  ::::::::::::::@@@@  @@@@@@  @@@@  ::::::::    ::    ::
::::::::::::::::::::::::::::::::::: ::::::::::::::@@@@@@@@@@@@@@@@@@@@@@@@@@OOOO::::::::::::   ::::::::::::@@@@@@@@@@@@@OOOOO@::::::::.. :''::::: ::::::::::  ::::::@@@@@@@@@@  @@::::::@@@@@@@@  ..    ::
::::::::::::::::::::::::::::::::::  ::::::::::::::@@@@@@@@@@@@@@@@@@@@@@@@@@OOOO::::::::::::    ::::::::::::@@@@@@@@@@@@OOOOO@::::::::..  ''::::  ::::::::::  ::::::@@@@@@@@@@  @@::::::  @@@@@@  ...   ::
:::::::::::::::::::::::::::::::   :::::::::::::::::@@@@@@@@@@@@@@@@@@@@@@@OOOO@@::::::::::::    ::::::::::::::@@OO@@OO@@OO@@OO@::::::::::: :::::  ::::::::: ::::::::::::::::::::            @@@@@@::::::::
::::::::::::::::::::::::::::::    ::::::::::::::::::@@@@@@@@@@@@@@@@@@@@@@OOOO@@::::::::::::   :::::::::::::::@@OO@@OO@@OO@@OO@:::::::::::  ::::  ::::::::: ::::::::::::::::::::            @@@@::@:::::::
::::::::::::::::::::::::::::::  ::::::::::::::::::::.@@@@@@@@@@@@@@@@@@@OOOOOO  :::::::::::   :::::::::::::::O@@OOOOOOOOOOOO@@::::::::::::  ::::::::::::::: ::::::::::::::::::::       @@@       :     :  
::::::::::::::::::::::::::::::  ::::::::::::::::::::..@@@@@@@@@@@@@@@@@@OOOOOO  ::::::::::.   ::::::::::::::@O@@OOOOOOOOOOOO@@:::::@::::::: ::::::::::::::: ::::::::::::::::::::    @@OOOO@@  @@@@''''''''
::::::::::::::::::::::::::::::  ::::::::::::::::::::::::@OOO@@@@@@@@@@@@@@@@  ::::::::::::::  ::::::::::::::OOOOOOOOOOOOOOOOO@@   @@@:::::  ::::  ::::::::::  ::::::::::::::::  @@OOOOOOOOOOOOOOOO    ::::
::::::::::::::::::::::::::::::  ::::::::::::::::::::::::@oOO@@@@@@@@@@@@@@@@  ::::::::::::::  ::::::::::::::OOOOOOOOOOOOOO@@     @@@::::  ::::  ::::::::::: ::::::::::::::::  @@OOOOOOOOOOOOOOOO@@  ::::::
::::::::::::::::::::::::::::: ::::::::::::::::::::::::::::OOOO@@@@@@@@@@@@@@::::::::::::::::  :::::::::::::::@OOOOOOOOOOOOOO     @O ::::::::::    :::::::::   ::::::::::     OOOOOOOOOOOOOOOOOOOOOOO::::::
::::::::::::::::::::::::::::  ::::::::::::::::::::::::::::OOOO@@@@@@@@@@@@@ ::::::::::::::::  ::::::::::::::::OOOOOOOOOOOOO     @@@ ::::::::::    ::::::::    ::::::::::     OOOOOOOOOOOOOOOOOOOOOOO::::::
::::::::::::::::::::::::::::::       :..........::::::::OO@@@@@@@@@@@@@ ::::::    ::::::::::  ::::::::  ::::::@@OOOOOOOOOO:::::: O:::::::::::::::::::::::::::: ::::::::::::: OOOOOOOOOOOOOOOOOOOOOOOO:::::
::::::::::::::::::::::::::::::        ..........::::::::OO@@@@@@@@@@@@@ ::::::    ::::::::::  ::::::::  ::::::@@OOOOOOOOO:::::::  :::::::::::::::::::::::::::: :::: :::::::: OOOOOOOOOOOOOOOOOOOOOOOO:::::
:::::::::::::::::::::::::::::::         :::::::::::::::::OOO@@@@@@@@@:::::::::::::::::::::::  :::::::::::::::::@@@OOOOOO::::::::::::::::::::::::::::::::::::::::::::::::::::::OOOOOOOOOOOOOOOOOOOOOOO:::::
:::::::::::::::::::::::::::::::.      .::::::::::::::::::OOO@@@@@@@@::::::::::  :@::::::::::  ::::::::::::::::::@@OOOOO:::::::::::::::::::::::::::::::::::::::::::::::::::::::OOOOOOOOOOOOOOOOOOOOOOO:::::
::::::::::::::::::::::::::::::::::::::::::::::::::::::::OO@@@@@@@@@::::::::::::::::::::::::  ::::::::::::::::::::@@@@@@::::::::::::::::::::::::::::::::::::::::::::::::::::::::::::::::::::::::OOOOOO:::::
::::::::::::::::::::::::::::::::::::::::::::::::::::::::OO@@@@@@@ ::::::::::::::::::::::::   :::::::::::::::::::::::::::::::::::::::::::::::::::::::::::::::::::::::::::::::::::::::::::::::::OOOOO:::::::
::::::::::::::::::::::::::::::::::::::::::::::::::::::OO@@@@@@@@ :::::::::::::::::::::::    :::::::::::::::::::::::::::::::::::::::::::::::::::::::::::::::::::::::::::::::::::::::::::::::::::::@@:::::::
::::::::::::::::::::::::::::::::::::::::::::::::::::::OO@@@@@@  ::::::::::::::::::::::::::::::::::::::::::::::::::::::::::::::::::::::::::::::::::::::::::::::::::::::::::::::::::::::::::::::::@@::::::::
::::::::::::::::::::::::::::::::::::::::::::::::::::::OOOO@@    ::::::::::::::::::::::::::::::::::::::::::::::::::::::::::::::::::::::::::::::::::::::::::::::::::::::::::::::::::::::::::::::::::::::::::
::::::::::::::::::::::::::::::::::::::::::::::::::::::OOOO@@    ::::::::::::::::::::::::::::::::::::::::::::::::::::::::::::::::::::::::::::::::::::::::::::::::::::::::::::::::::::::::::::::::::::::::::
:::::::::::::::::::::::::::::::::::::::::::::::::::::::OOO::::::::::::::::::::::::::::::::::::::::::::::::::::::::::::::::::::::::::::::::::::::::::::::::::::::::::::::::::::::::::::::::::::::::::::::::
:::::::::::::::::::::::::::::::::::::::::::::::::::::::OOO::::::::::::::::::::::::::::::::::::::::::::::::::::::::::::::::::::::::::::::::::::::::::::::::::::::::::::::::::::::::::::::::::::::::::::::::
:::::::::::::::::::::::::::::::::::::::::::::::::::::::O::::::::::::::::::::::::::::::::::::::::::::::::::::::::::::::::::::::::::::::::::::::::::::::::::::::::::::::::::::::::::::::::::::::::::::::::::
:::::::::::::::::::::::::::::::::::::::::::::::::::::::oooo:::::::::::::::::::::::::::::::::::::::::::::::::::::::::::::::::::::::::::::::::::::::::::::::::::::::::::::::::::::::::::::::::::::::::::::::
::::::::::::::::::::::::::::::::::::::::::::::::::::::::::::::::::::::::::::::::::::::::::::::::::::::::::::::::::::::::::::::::::::::::::::::::::::::::::::::::::::::::::::::::::::::::::::::::::::::::::
::::::::::::::::::::::::::::::::::::::::::::::::::::::::::::::::::::::::::::::::::::::::::::::::::::::::::::::::::::::::::::::::::::::::::::::::::::::::::::::::::::::::::::::::::::::::::::::::::::::::::
:::::::::::::::::::::::::::::::::::::::::::::::::::::::::::::::::::::::::::::::::::::::::::::::::::::::::::::::::::::::::::::::::::::::::::::::::::::::::::::::: ::::::::::::::::::::: :::::::::::::::::::
:::::::::::::::::::::::::::::::::::::::::::::::::::::::::::::::OOO::::::::::::::::::::::::::::::::::::::::::::::::::::::::::::::::::::::::::::::::::::::::::::::::::::::::::::::::::::::::::::::::::::::::
::::::::::::::::::::::::::::::::::::::::::::::::::::::::::::OOOO:::::::::::::::::::::::::::::::::::::::::::::::::::::: ::::::::::::::::::::: :::::::::::::::::::::OOOOOOOOOOOOOOOOOOOOOOO:::::::::::::::::
::::::::::::::::::::::::::::::::::::::::::::::::::::::  OOOOOOOO:::::::::::::::::::::::::::::::::::::::::::::::::::::::::::::::::::OOOOOOOooOOOOOOOOOOOOOOOOOOOOOOOOOOOOOOOOOOOOOOOOOOOOOOOOOOOOOOOOOOOOOO
:::::::::::::::::::::::::::::::::::::::::::::::::OO:  OOOOOOOOOO ::::::::::::::::::::::::::::::::::OOOOOOOOOOOOOOOOOOOOOOOOOOOOOOOOOOOOOOOOOOOOOOOOOOOOOOOOOOOOOOOOOOOOOOOOOOOOOOOOOOOOOOOOOOOOOOOOOOOOOOO
::::::::::::::::::::                OOOOOOOOOOOOOOOOOOOOOOOOOOOO              ::::::::::::ooOOOOOOOOOOOOOOOOOOOOOOOOOOOOOOOOOOOOOOOOOOOOOOOOOOOOOOOOOOOOOOOOOOOOOOOOOOOOOOOOOOOOOOOOOOOOOOOOOOOOOOOOOOOOOO
:::::::::::::OOOOOOOOOOOOOOOOOOOOOOOOOOOOOOOOOOOOOOOOOOOOOOOOOOO                     OOOOOOOOOOOOOOOOOOOOOOOOOOOOOOOOOOOOOOOOOOOOOOOOOOOOOOOOOOOOOOOOOOOOOOOOOOOOOOOOOOOOOOOOOOOOOOOOOOOOOOOOOOOOOOOOOOOOO
     OOOOOOOOOOOOOOOOOOOOOOOOOOOOOOOOOOOOOOOOOOOOOOOOOOOOOOOOOOOOOOOOO           OOOOOOOOOOOOOOOOOOOOOOOOOOOOOOOOOOOOOOOOOOOOOOOOOOOOOOOOOOOOOOOOOOOOOOOOOOOOOOOOOOOOOOOOOOOOOOOOOOOOOOOOOOOOOOOOOOOOOOOOO
OOOOOOOOOOOOOOOOOOOOOOOOOOOOOOOOOOOOOOOOOOOOOOOOOOOOOOOOOOOOOOOOOOOOOOOOOOOOOOOOOOOOOOOOOOOOOOOOOOOOOOOOOOOOOOOOOOOOOOOOOOOOOOOOOOOOOOOOOOOOOOOOOOOOOOOOOOOOOOOOOOOOOOOOOOOOOOOOOOOOOOOOOOOOOOOOOOOOOOOOOO
OOOOOOOOOOOOOOOOOOOOOOOOOOOOOOOOOOOOOOOOOOOOOOOOOOOOOOOOOOOOOOOOOOOOOOOOOOOOOOOOOOOOOOOOOOOOOOOOOOOOOOOOOOOOOOOOOOOOOOOOOOOOOOOOOOOOOOOOOOOOOOOOOOOOOOOOOOOOOOOOOOOOOOOOOOOOOOOOOOOOOOOOOOOOOOOOOOOOOOOOOO
OOOOOOOOOOOOOOOOOOOOOOOOOOOOOOOOOOOOOOOOOOOOOOOOOOOOOOOOOOOOOOOOOOOOOOOOOOOOOOOOOOOOOOOOOOOOOOOOOOOOOOOOOOOOOOOOOOOOOOOOOOOOOOOOOOOOOOOOOOOOOOOOOOOOOOOOOOOOOOOOOOOOOOOOOOOOOOOOOOOOOOOOOOOOOOOOOOOOOOOOOO
OOOOOOOOOOOOOOOOOOOOOOOOOOOOOOOOOOOOOOOOOOOOOOOOOOOOOOOOOOOOOOOOOOOOOOOOOOOOOOOOOOOOOOOOOOOOOOOOOOOOOOOOOOOOOOOOOOOOOOOOOOOOOOOOOOOOOOOOOOOOOOOOOOOOOOOOOOOOOOOOOOOOOOOOOOOOOOOOOOOOOOOOOOOOOOOOOOOOOOOOOO
OOOOOOOOOOOOOOOOOOOOOOOOOOOOOOOOOOOOOOOOOOOOOOOOOOOOOOOOOOOOOOOOOOOOOOOOOOOOOOOOOOOOOOOOOOOOOOOOOOOOOOOOOOOOOOOOOOOOOOOOOOOOOOOOOOOOOOOOOOOOOOOOOOOOOOOOOOOOOOOOOOOOOOOOOOOOOOOOOOOOOOOOOOOOOOOOOOOOOOOOOO
OOOOOOOOOOOOOOOOOOOOOOOOOOOOOOOOOOOOOOOOOOOOOOOOOOOOOOOOOOOOOOOOOOOOOOOOOOOOOOOOOOOOOOOOOOOOOOOOOOOOOOOOOOOOOOOOOOOOOOOOOOOOOOOOOOOOOOOOOOOOOOOOOOOOOOOOOOOOOOOOOOOOOOOOOOOOOOOOOOOOOOOOOOOOOOOOOOOOOOOOOO